#################################
#*************ifj***************#
#*************geh***************#
#*******************************#
d*******************************c
#*******************************#
#*******************************#
#*****************************@*#
#aaa#########################bbb#
