################
#**************#
#**************#
#**************#
#**************#
#******@*******#
#**************#
#**************#
#**************#
################
